11111111111111111111111111
1E000000000000000C00000C01
10100101001000001010010001
10100100101010100010010001
1P0000000C00C0000000000001
11111111111111111111111111