11111111111111111111111111
100000C0000000000C00000C01
1010010101110000101001C101
1010010010101010001001E101
1P0000000C00C0100000000001
11111111111111111111111111
