11111111111111111111111111
100000C0000000000C00000C01
10100101011100001010010001
1010010010101010001001E001
1P0000000C00C0100000000001
11111111111111111111111111