111111
100001
1P0EC1
100001
111111
